NO ./textures/bricks.png
SO ./textures/bricks.png
WE ./textures/bricks.png
EA ./textures/bricks.png
D ./textures/Door.png

F 30,30,30
C 30,30,30

111111111111111111111111111111
1EDDDDDDDDDDDDDDDDDDDDDDDDDDD1
1111111111111111111111111111D1
1DDDDDDDDDDDDDDDDDDDDDDDDDDDD1
1D1111111111111111111111111111
1DDDDDDDDDDDDDDDDDDDDDDDDDDDD1
1111111111111111111111111111D1
1DDDDDDDDDDDDDDDDDDDDDDDDDDDD1
111111111111111111111111111111