NO ./textures/bricks.png
SO ./textures/bricks.png
WE ./textures/bricks.png
EA ./textures/bricks.png
D ./textures/Door.png

F 30,30,30
C 30,30,30

111111111111111111111111111111   111111111111111111111111111111   111111111111111111111111111111
10000000000000N000000000000001   100000000000000000000000000001   100000000000000000000000000001
100000000000000000000000000001   100000000000000000000000000001   100000000000000000000000000001
100000000000000000000000000001111100000000000000000000000000001111100000000000000000000000000001
10000000000000P00000000000000D000D0000000000000000000000000000D000D00000000000000000000000000001
100000000000000000000000000001111100000000000000000000000000001111100000000000000000000000000001
100000000000000000000000000001   100000000000000000000000000001   100000000000000000000000000001
100000000000000000000000000001   100000000000000000000000000001   100000000000000000000000000001
11111111111111D111111111111111   11111111111111D111111111111111   11111111111111D111111111111111
             101                              101                              101              
             101                              101                              101              
11111111111111D111111111111111   11111111111111D111111111111111   11111111111111D111111111111111
100000000000000000000000000001   100000000000000000000000000001   100000000000000000000000000001
100000000000000000000000000001   10011111111111D111111111111001   100000000000000000000000000001
100000000000000000000000000001111101000000000000000000000000101111100000000000000000000000000001
10000000000000000000000000000D000D0D000000000000000000000000D0D000D00000000000000000000000000001
100000000000000000000000000001111101000000000000000000000000101111100000000000000000000000000001
100000000000000000000000000001   10011111111111D111111111111001   100000000000000000000000000001
100000000000000000000000000001   100000000000000000000000000001   100000000000000000000000000001
11111111111111D111111111111111   11111111111111D111111111111111   11111111111111D111111111111111
             101                              101                              101              
             101                              101                              101              
11111111111111D111111111111111   11111111111111D111111111111111   11111111111111D111111111111111
100000000000000000000000000001   100000000000000000000000000001   100000000000000000000000000001
100000000000000000000000000001   100000000000000000000000000001   100011111111111111111111110001
100000000000000000000000000001111100000000000000000000000000001111100010000000000000000000010001
10000000000000000000000000000D000D0000000000000000000000000000D000D00010000000000P00000000010001
100000000000000000000000000001111100000000000000000000000000001111100010000000000000000000010001
100000000000000000000000000001   100000000000000000000000000001   100011111111111111111111110001
100000000000000000000000000001   100000000000000000000000000001   100000000000000000000000000001
111111111111111111111111111111   111111111111111111111111111111   111111111111111111111111111111
