NO ./textures/bricks.png
SO ./textures/bricks.png
WE ./textures/bricks.png
EA ./textures/bricks.png
D ./textures/Door.png

F 30,30,30
C 30,30,30

111111111111111111111111111111
1E0000000000000000000000000001
101010101010101010101010101001
100000000000000000000000000001
10101010101010P010101010101001
100000000000000000000000000001
101010101010101010101010101001
100000000000000000000000000001
11111111111111D111111111111111
             101              
             101              
11111111111111D111111111111111
100000000000000000000000000001
100000000000000000000000000001
100000000000000000000000000001
100000000000000000000000000001
100000000000000000000000000001
100000000000000000000000000001
100000000000000000000000000001
11111111111111D111111111111111
             101              
             101              
11111111111111D111111111111111
100000000000000000000000000001
101010101010101010101010101001
100000000000000000000000000001
10101010101010P010101010101001
100000000000000000000000000001
101010101010101010101010101001
100000000000000000000000000001
111111111111111111111111111111