NO ./textures/stonewall_grayscale.png
SO ./textures/stonewall_normal.png
WE ./textures/stonewall000.png
EA ./textures/stonewall001.png

F 220,100,0
C 225,30,255

11111111111
10000000001
11111111111



        1111111111111111111111111
        1000000000110000000000001
        1011000001110000000000001
        1001000000000000000000001
111111111011000001110000000000001
100000000011000001110111111111111
11110111111111011100000010001
11110111111111011101010010001
11000000110101011100000010001
1N000000000000011000000100001
10000000000000001101010010001
1100000111010101111101111000111
11110111 1110101 101111010001
11111111 1111111 111111111111