NO ./textures/dungeontile.png
SO ./textures/dungeontile.png
WE ./textures/dungeontile.png
EA ./textures/dungeontile.png

F 42,42,42
C 42,42,42

11111111111
1N000000001
11111111111