NO ./textures/stonewall_grayscale.png
SO ./textures/stonewall_normal.png
WE ./textures/stonewall000.png
EA ./textures/stonewall001.png

F 220,100,0
C 225,30,255

11111111111
1N000000001
11111111111


