NO ./textures/Rickrolling-PNG-Transparent-Image.png
SO ./textures/Rickrolling-PNG-Transparent-Image.png
WE ./textures/Rickrolling-PNG-Transparent-Image.png
EA ./textures/Rickrolling-PNG-Transparent-Image.png
D ./textures/Door.png

F ./textures/Rickrolling-PNG-Transparent-Image.png
C ./textures/Rickrolling-PNG-Transparent-Image.png

111111111111111111111111111111  111111111111111111111111111111  111111111111111111111111111111
10000000000000W000000000000001  100000000000000000000000000001  100000000000000000000000000001
100000000000000000000000000001  100000000000000000000000000001  100000000000000000000000000001
1000000000000000000000000000011110000000000000000000000000000111100000000000000000000000000001
1000000000000PP00000000000000D00D0000000000000000000000000000D00D00000000000000000000000000001
1000000000000000000000000000011110000000000000000000000000000111100000000000000000000000000001
100000000000000000000000000001  100000000000000000000000000001  100000000000000000000000000001
100000000000000000000000000001  100000000000000000000000000001  100000000000000000000000000001
11111111111111D111111111111111  11111111111111D111111111111111  11111111111111D111111111111111
             101                             101                             101              
             101                             101                             101              
11111111111111D111111111111111  11111111111111D111111111111111  11111111111111D111111111111111
100000000000000000000000000001  100000000000000000000000000001  100000000000000000000000000001
100000000000000000000000000001  100000000000000000000000000001  100000000000000000000000000001
1000000000000000000000000000011110000000000000000000000000000111100000000000000000000000000001
10000000000000000000000000000D00D0000000000000000000000000000D00D00000000000000000000000000001
1000000000000000000000000000011110000000000000000000000000000111100000000000000000000000000001
100000000000000000000000000001  100000000000000000000000000001  100000000000000000000000000001
100000000000000000000000000001  100000000000000000000000000001  100000000000000000000000000001
11111111111111D111111111111111  11111111111111D111111111111111  11111111111111D111111111111111
             101                             101                             101              
             101                             101                             101              
11111111111111D111111111111111  11111111111111D111111111111111  11111111111111D111111111111111
100000000000000000000000000001  100000000000000000000000000001  100000000000000000000000000001
100000000000000000000000000001  100000000000000000000000000001  100011111111111111111111110001
1000000000000000000000000000011110000000000000000000000000000111100010000000000000000000010001
10000000000000000000000000000D00D0000000000000000000000000000D00D00010000000000000000000010001
1000000000000000000000000000011110000000000000000000000000000111100010000000000000000000010001
100000000000000000000000000001  100000000000000000000000000001  100011111111111111111111110001
100000000000000000000000000001  100000000000000000000000000001  100000000000000000000000000001
111111111111111111111111111111  111111111111111111111111111111  111111111111111111111111111111


111111111111111111111111111111  111111111111111111111111111111  111111111111111111111111111111
100000000000000000000000000001  100000000000000000000000000001  100000000000000000000000000001
100000000000000000000000000001  100000000000000000000000000001  100000000000000000000000000001
1000000000000000000000000000011110000000000000000000000000000111100000000000000000000000000001
10000000000000000000000000000D00D0000000000000000000000000000D00D00000000000000000000000000001
1000000000000000000000000000011110000000000000000000000000000111100000000000000000000000000001
100000000000000000000000000001  100000000000000000000000000001  100000000000000000000000000001
100000000000000000000000000001  100000000000000000000000000001  100000000000000000000000000001
11111111111111D111111111111111  11111111111111D111111111111111  11111111111111D111111111111111
             101                             101                             101              
             101                             101                             101              
11111111111111D111111111111111  11111111111111D111111111111111  11111111111111D111111111111111
100000000000000000000000000001  100000000000000000000000000001  100000000000000000000000000001
100000000000000000000000000001  10011111111111D111111111111001  100000000000000000000000000001
1000000000000000000000000000011110100000000000000000000000010111100000000000000000000000000001
10000000000000000000000000000D00D0D000000000000000000000000D0D00D00000000000000000000000000001
1000000000000000000000000000011110100000000000000000000000010111100000000000000000000000000001
100000000000000000000000000001  10011111111111D111111111111001  100000000000000000000000000001
100000000000000000000000000001  100000000000000000000000000001  100000000000000000000000000001
11111111111111D111111111111111  11111111111111D111111111111111  11111111111111D111111111111111
             101                             101                             101              
             101                             101                             101              
11111111111111D111111111111111  11111111111111D111111111111111  11111111111111D111111111111111
100000000000000000000000000001  100000000000000000000000000001  100000000000000000000000000001
100000000000000000000000000001  100000000000000000000000000001  100011111111111111111111110001
1000000000000000000000000000011110000000000000000000000000000111100010000000000000000000010001
10000000000000000000000000000D00D0000000000000000000000000000D00D0001000000000P000000000010001
1000000000000000000000000000011110000000000000000000000000000111100010000000000000000000010001
100000000000000000000000000001  100000000000000000000000000001  100011111111111111111111110001
100000000000000000000000000001  100000000000000000000000000001  100000000000000000000000000001
111111111111111111111111111111  111111111111111111111111111111  111111111111111111111111111111
